date,amount,category,merchant,description,type,currency,balance
2024-01-01,-1037.19,Healthcare,Local Clinic,Healthcare at Local Clinic,debit,INR,-1037.19
2024-01-01,-574.15,Transport,Delhi Metro,Transport at Delhi Metro,debit,INR,-1611.3400000000001
2024-01-02,-356.48,Groceries,Local Kirana,Groceries at Local Kirana,debit,INR,-1967.8200000000002
2024-01-02,-1990.26,Other,Online Payment,Other at Online Payment,debit,INR,-3958.08
2024-01-02,-841.21,Transport,Auto Rickshaw,Transport at Auto Rickshaw,debit,INR,-4799.29
2024-01-03,-1843.87,Other,UPI Transfer,Other at UPI Transfer,debit,INR,-6643.16
2024-01-04,-140.54,Transport,Uber,Transport at Uber,debit,INR,-6783.7
2024-01-04,-842.57,Entertainment,Amazon Prime,Entertainment at Amazon Prime,debit,INR,-7626.2699999999995
2024-01-05,-1027.16,Healthcare,Hospital,Healthcare at Hospital,debit,INR,-8653.43
2024-01-06,-1081.9,Groceries,DMart,Groceries at DMart,debit,INR,-9735.33
2024-01-07,-3570.93,Shopping,Flipkart,Shopping at Flipkart,debit,INR,-13306.26
2024-01-08,-207.56,Dining Out,Domino's,Dining Out at Domino's,debit,INR,-13513.82
2024-01-08,-1264.72,Shopping,Amazon India,Shopping at Amazon India,debit,INR,-14778.539999999999
2024-01-08,-20.03,Transport,Indian Oil,Transport at Indian Oil,debit,INR,-14798.57
2024-01-08,-500.43,Utilities,Airtel,Utilities at Airtel,debit,INR,-15299.0
2024-01-09,-1868.55,Other,Miscellaneous,Other at Miscellaneous,debit,INR,-17167.55
2024-01-09,-1022.18,Groceries,Big Bazaar,Groceries at Big Bazaar,debit,INR,-18189.73
2024-01-10,-2192.53,Groceries,DMart,Groceries at DMart,debit,INR,-20382.26
2024-01-11,-2062.72,Groceries,Local Kirana,Groceries at Local Kirana,debit,INR,-22444.98
2024-01-12,-1107.6,Utilities,Airtel,Utilities at Airtel,debit,INR,-23552.579999999998
2024-01-12,-1305.92,Utilities,BWSSB,Utilities at BWSSB,debit,INR,-24858.5
2024-01-12,-273.27,Transport,Delhi Metro,Transport at Delhi Metro,debit,INR,-25131.77
2024-01-13,-102.49,Other,UPI Transfer,Other at UPI Transfer,debit,INR,-25234.260000000002
2024-01-15,-416.07,Transport,Uber,Transport at Uber,debit,INR,-25650.33
2024-01-16,-635.79,Transport,HP Petrol,Transport at HP Petrol,debit,INR,-26286.120000000003
2024-01-17,-537.18,Transport,Ola,Transport at Ola,debit,INR,-26823.300000000003
2024-01-18,-2825.43,Shopping,Medical Store,Shopping at Medical Store,debit,INR,-29648.730000000003
2024-01-19,-323.42,Utilities,Airtel,Utilities at Airtel,debit,INR,-29972.15
2024-01-20,-466.28,Other,UPI Transfer,Other at UPI Transfer,debit,INR,-30438.43
2024-01-21,-1270.85,Utilities,DTH Recharge,Utilities at DTH Recharge,debit,INR,-31709.28
2024-01-21,-627.12,Groceries,Local Kirana,Groceries at Local Kirana,debit,INR,-32336.399999999998
2024-01-22,-1482.93,Other,Online Payment,Other at Online Payment,debit,INR,-33819.329999999994
2024-01-23,-612.88,Shopping,Medical Store,Shopping at Medical Store,debit,INR,-34432.20999999999
2024-01-24,-1318.2,Groceries,Reliance Fresh,Groceries at Reliance Fresh,debit,INR,-35750.40999999999
2024-01-25,-2269.48,Groceries,Big Bazaar,Groceries at Big Bazaar,debit,INR,-38019.88999999999
2024-01-26,-357.5,Groceries,More Supermarket,Groceries at More Supermarket,debit,INR,-38377.38999999999
2024-01-26,-2338.73,Groceries,Reliance Fresh,Groceries at Reliance Fresh,debit,INR,-40716.119999999995
2024-01-26,-363.21,Utilities,Gas Agency,Utilities at Gas Agency,debit,INR,-41079.329999999994
2024-01-26,-700.58,Shopping,Local Mall,Shopping at Local Mall,debit,INR,-41779.909999999996
2024-01-27,-1415.65,Shopping,Amazon India,Shopping at Amazon India,debit,INR,-43195.56
2024-01-27,-1302.89,Shopping,Brand Factory,Shopping at Brand Factory,debit,INR,-44498.45
2024-01-27,-458.8,Healthcare,Medical Tests,Healthcare at Medical Tests,debit,INR,-44957.25
2024-01-28,-145.35,Dining Out,CCD,Dining Out at CCD,debit,INR,-45102.6
2024-01-28,-567.69,Dining Out,McDonald's India,Dining Out at McDonald's India,debit,INR,-45670.29
2024-01-28,-2037.0,Utilities,Gas Agency,Utilities at Gas Agency,debit,INR,-47707.29
2024-01-29,-707.09,Entertainment,Gym,Entertainment at Gym,debit,INR,-48414.38
2024-01-30,-1752.31,Shopping,Medical Store,Shopping at Medical Store,debit,INR,-50166.689999999995
2024-01-30,-194.74,Transport,BMTC,Transport at BMTC,debit,INR,-50361.42999999999
2024-01-30,-456.61,Other,Miscellaneous,Other at Miscellaneous,debit,INR,-50818.03999999999
2024-01-30,-457.44,Dining Out,KFC,Dining Out at KFC,debit,INR,-51275.479999999996
2024-01-31,-1515.46,Groceries,Spencer's,Groceries at Spencer's,debit,INR,-52790.939999999995
2024-01-31,25224.45,Income,Tech Company,Monthly Salary,credit,INR,-27566.489999999994
2024-02-01,-590.48,Entertainment,Netflix India,Entertainment at Netflix India,debit,INR,-28156.969999999994
2024-02-01,-424.64,Groceries,Reliance Fresh,Groceries at Reliance Fresh,debit,INR,-28581.609999999993
2024-02-02,-280.03,Entertainment,Netflix India,Entertainment at Netflix India,debit,INR,-28861.639999999992
2024-02-02,-1896.29,Groceries,Reliance Fresh,Groceries at Reliance Fresh,debit,INR,-30757.929999999993
2024-02-03,-903.74,Healthcare,Medical Tests,Healthcare at Medical Tests,debit,INR,-31661.669999999995
2024-02-03,-1672.52,Other,UPI Transfer,Other at UPI Transfer,debit,INR,-33334.189999999995
2024-02-03,-1547.33,Groceries,Big Bazaar,Groceries at Big Bazaar,debit,INR,-34881.52
2024-02-04,-1554.9,Groceries,Big Bazaar,Groceries at Big Bazaar,debit,INR,-36436.42
2024-02-04,-703.12,Entertainment,Amazon Prime,Entertainment at Amazon Prime,debit,INR,-37139.54
2024-02-05,-326.01,Transport,Delhi Metro,Transport at Delhi Metro,debit,INR,-37465.55
2024-02-08,-1115.95,Healthcare,Apollo Pharmacy,Healthcare at Apollo Pharmacy,debit,INR,-38581.5
2024-02-09,-1223.19,Utilities,Reliance Jio,Utilities at Reliance Jio,debit,INR,-39804.69
2024-02-11,-1165.23,Utilities,Airtel,Utilities at Airtel,debit,INR,-40969.920000000006
2024-02-12,-437.98,Dining Out,Local Restaurant,Dining Out at Local Restaurant,debit,INR,-41407.90000000001
2024-02-13,-776.1,Dining Out,Local Restaurant,Dining Out at Local Restaurant,debit,INR,-42184.00000000001
2024-02-13,-377.13,Entertainment,Gym,Entertainment at Gym,debit,INR,-42561.130000000005
2024-02-14,-1333.6,Groceries,Big Bazaar,Groceries at Big Bazaar,debit,INR,-43894.73
2024-02-14,-774.86,Dining Out,McDonald's India,Dining Out at McDonald's India,debit,INR,-44669.590000000004
2024-02-14,-1384.37,Groceries,More Supermarket,Groceries at More Supermarket,debit,INR,-46053.96000000001
2024-02-15,-314.52,Transport,Indian Oil,Transport at Indian Oil,debit,INR,-46368.48
2024-02-17,-1047.25,Utilities,Airtel,Utilities at Airtel,debit,INR,-47415.73
2024-02-17,-1601.51,Groceries,Spencer's,Groceries at Spencer's,debit,INR,-49017.240000000005
2024-02-17,-127.2,Dining Out,KFC,Dining Out at KFC,debit,INR,-49144.44
2024-02-18,-286.34,Transport,Delhi Metro,Transport at Delhi Metro,debit,INR,-49430.78
2024-02-19,-2768.48,Shopping,Brand Factory,Shopping at Brand Factory,debit,INR,-52199.26
2024-02-19,-961.98,Groceries,DMart,Groceries at DMart,debit,INR,-53161.240000000005
2024-02-20,-84.38,Transport,Ola,Transport at Ola,debit,INR,-53245.62
2024-02-21,-479.87,Other,Online Payment,Other at Online Payment,debit,INR,-53725.490000000005
2024-02-22,-3834.24,Shopping,Local Mall,Shopping at Local Mall,debit,INR,-57559.73
2024-02-22,-1393.31,Shopping,Medical Store,Shopping at Medical Store,debit,INR,-58953.04
2024-02-23,-739.97,Dining Out,CCD,Dining Out at CCD,debit,INR,-59693.01
2024-02-23,-703.52,Utilities,BESCOM,Utilities at BESCOM,debit,INR,-60396.53
2024-02-24,-1601.34,Utilities,DTH Recharge,Utilities at DTH Recharge,debit,INR,-61997.869999999995
2024-02-24,-483.93,Shopping,Myntra,Shopping at Myntra,debit,INR,-62481.799999999996
2024-02-25,-170.52,Other,Online Payment,Other at Online Payment,debit,INR,-62652.31999999999
2024-02-25,-1203.14,Shopping,Local Mall,Shopping at Local Mall,debit,INR,-63855.45999999999
2024-02-26,-299.35,Entertainment,PVR Cinemas,Entertainment at PVR Cinemas,debit,INR,-64154.80999999999
2024-02-27,-1394.21,Groceries,Local Kirana,Groceries at Local Kirana,debit,INR,-65549.01999999999
2024-02-28,-321.63,Entertainment,PVR Cinemas,Entertainment at PVR Cinemas,debit,INR,-65870.65
2024-02-29,-360.27,Shopping,Amazon India,Shopping at Amazon India,debit,INR,-66230.92
2024-02-29,30297.06,Income,Tech Company,Monthly Salary,credit,INR,-35933.86
2024-03-01,-659.35,Entertainment,Netflix India,Entertainment at Netflix India,debit,INR,-36593.21
2024-03-01,-1080.43,Groceries,Local Kirana,Groceries at Local Kirana,debit,INR,-37673.64
2024-03-02,-714.49,Transport,Ola,Transport at Ola,debit,INR,-38388.13
2024-03-02,-2014.63,Groceries,Big Bazaar,Groceries at Big Bazaar,debit,INR,-40402.759999999995
2024-03-02,-316.75,Groceries,Big Bazaar,Groceries at Big Bazaar,debit,INR,-40719.509999999995
2024-03-03,-1409.65,Groceries,DMart,Groceries at DMart,debit,INR,-42129.159999999996
2024-03-03,-2597.9,Groceries,Local Kirana,Groceries at Local Kirana,debit,INR,-44727.06
2024-03-03,-533.95,Dining Out,Domino's,Dining Out at Domino's,debit,INR,-45261.009999999995
2024-03-04,-1735.55,Groceries,Big Bazaar,Groceries at Big Bazaar,debit,INR,-46996.56
2024-03-04,-2875.19,Groceries,More Supermarket,Groceries at More Supermarket,debit,INR,-49871.75
2024-03-05,-2010.83,Groceries,Local Kirana,Groceries at Local Kirana,debit,INR,-51882.58
2024-03-05,-734.67,Healthcare,Doctor Visit,Healthcare at Doctor Visit,debit,INR,-52617.25
2024-03-06,-683.51,Dining Out,Local Restaurant,Dining Out at Local Restaurant,debit,INR,-53300.76
2024-03-06,-1724.18,Groceries,Spencer's,Groceries at Spencer's,debit,INR,-55024.94
2024-03-06,-5155.56,Shopping,Brand Factory,Shopping at Brand Factory,debit,INR,-60180.5
2024-03-07,-595.69,Utilities,Reliance Jio,Utilities at Reliance Jio,debit,INR,-60776.19
2024-03-08,-706.48,Dining Out,CCD,Dining Out at CCD,debit,INR,-61482.670000000006
2024-03-08,-2346.19,Groceries,More Supermarket,Groceries at More Supermarket,debit,INR,-63828.86000000001
2024-03-09,-201.41,Other,ATM,Other at ATM,debit,INR,-64030.27000000001
2024-03-09,-633.82,Transport,Indian Oil,Transport at Indian Oil,debit,INR,-64664.09000000001
2024-03-10,-101.72,Dining Out,McDonald's India,Dining Out at McDonald's India,debit,INR,-64765.81000000001
2024-03-12,-323.12,Dining Out,CCD,Dining Out at CCD,debit,INR,-65088.930000000015
2024-03-13,-1311.61,Groceries,More Supermarket,Groceries at More Supermarket,debit,INR,-66400.54000000001
2024-03-14,-1979.27,Other,UPI Transfer,Other at UPI Transfer,debit,INR,-68379.81000000001
2024-03-14,-507.81,Dining Out,Domino's,Dining Out at Domino's,debit,INR,-68887.62000000001
2024-03-16,-1761.8,Groceries,More Supermarket,Groceries at More Supermarket,debit,INR,-70649.42000000001
2024-03-16,-291.91,Entertainment,Netflix India,Entertainment at Netflix India,debit,INR,-70941.33000000002
2024-03-17,-500.27,Groceries,Reliance Fresh,Groceries at Reliance Fresh,debit,INR,-71441.60000000002
2024-03-17,-1442.49,Groceries,Local Kirana,Groceries at Local Kirana,debit,INR,-72884.09000000003
2024-03-17,-648.23,Entertainment,BookMyShow,Entertainment at BookMyShow,debit,INR,-73532.32000000002
2024-03-18,-597.07,Transport,Delhi Metro,Transport at Delhi Metro,debit,INR,-74129.39000000003
2024-03-18,-1604.86,Groceries,Spencer's,Groceries at Spencer's,debit,INR,-75734.25000000003
2024-03-19,-1106.78,Groceries,Big Bazaar,Groceries at Big Bazaar,debit,INR,-76841.03000000003
2024-03-19,-885.94,Utilities,Gas Agency,Utilities at Gas Agency,debit,INR,-77726.97000000003
2024-03-19,-3477.34,Shopping,Medical Store,Shopping at Medical Store,debit,INR,-81204.31000000003
2024-03-20,-1311.28,Shopping,Medical Store,Shopping at Medical Store,debit,INR,-82515.59000000003
2024-03-20,-762.27,Entertainment,Netflix India,Entertainment at Netflix India,debit,INR,-83277.86000000003
2024-03-21,-1944.07,Shopping,Medical Store,Shopping at Medical Store,debit,INR,-85221.93000000004
2024-03-21,-1778.73,Utilities,Airtel,Utilities at Airtel,debit,INR,-87000.66000000003
2024-03-21,-268.02,Transport,Auto Rickshaw,Transport at Auto Rickshaw,debit,INR,-87268.68000000004
2024-03-22,-930.0,Other,UPI Transfer,Other at UPI Transfer,debit,INR,-88198.68000000004
2024-03-23,-512.68,Dining Out,CCD,Dining Out at CCD,debit,INR,-88711.36000000003
2024-03-23,-1769.42,Groceries,DMart,Groceries at DMart,debit,INR,-90480.78000000003
2024-03-24,-633.7,Shopping,Myntra,Shopping at Myntra,debit,INR,-91114.48000000003
2024-03-24,-1128.08,Groceries,DMart,Groceries at DMart,debit,INR,-92242.56000000003
2024-03-25,-401.48,Dining Out,Domino's,Dining Out at Domino's,debit,INR,-92644.04000000002
2024-03-25,-1770.67,Groceries,More Supermarket,Groceries at More Supermarket,debit,INR,-94414.71000000002
2024-03-26,-410.57,Other,Online Payment,Other at Online Payment,debit,INR,-94825.28000000003
2024-03-27,-660.82,Shopping,Medical Store,Shopping at Medical Store,debit,INR,-95486.10000000003
2024-03-27,-421.92,Groceries,Spencer's,Groceries at Spencer's,debit,INR,-95908.02000000003
2024-03-28,-691.07,Groceries,Big Bazaar,Groceries at Big Bazaar,debit,INR,-96599.09000000004
2024-03-29,-3132.78,Shopping,Amazon India,Shopping at Amazon India,debit,INR,-99731.87000000004
2024-03-29,-998.24,Healthcare,Local Clinic,Healthcare at Local Clinic,debit,INR,-100730.11000000004
2024-03-29,-518.22,Entertainment,PVR Cinemas,Entertainment at PVR Cinemas,debit,INR,-101248.33000000005
2024-03-29,-312.95,Other,Miscellaneous,Other at Miscellaneous,debit,INR,-101561.28000000004
2024-03-30,-2048.94,Groceries,Local Kirana,Groceries at Local Kirana,debit,INR,-103610.22000000004
2024-03-30,-678.65,Groceries,Local Kirana,Groceries at Local Kirana,debit,INR,-104288.87000000004
2024-03-30,-204.51,Dining Out,CCD,Dining Out at CCD,debit,INR,-104493.38000000003
2024-03-31,72083.1,Income,Local Business,Monthly Salary,credit,INR,-32410.280000000028
2024-04-01,111186.66,Income,Tech Company,Monthly Salary,credit,INR,78776.37999999998
2024-04-02,-2517.4,Groceries,Local Kirana,Groceries at Local Kirana,debit,INR,76258.97999999998
2024-04-04,-1818.5,Groceries,Big Bazaar,Groceries at Big Bazaar,debit,INR,74440.47999999998
2024-04-05,-907.32,Entertainment,Hotstar,Entertainment at Hotstar,debit,INR,73533.15999999997
2024-04-06,-2979.26,Shopping,Medical Store,Shopping at Medical Store,debit,INR,70553.89999999998
2024-04-06,-3471.67,Shopping,Flipkart,Shopping at Flipkart,debit,INR,67082.22999999998
2024-04-07,-1888.93,Groceries,Big Bazaar,Groceries at Big Bazaar,debit,INR,65193.29999999998
2024-04-08,-2309.93,Shopping,Local Mall,Shopping at Local Mall,debit,INR,62883.36999999998
2024-04-08,-2064.88,Groceries,DMart,Groceries at DMart,debit,INR,60818.48999999998
2024-04-08,-710.17,Transport,HP Petrol,Transport at HP Petrol,debit,INR,60108.319999999985
2024-04-08,-922.21,Entertainment,Gym,Entertainment at Gym,debit,INR,59186.109999999986
2024-04-09,-2271.05,Other,Miscellaneous,Other at Miscellaneous,debit,INR,56915.05999999998
2024-04-09,-2740.1,Groceries,Reliance Fresh,Groceries at Reliance Fresh,debit,INR,54174.959999999985
2024-04-09,-292.46,Entertainment,Gym,Entertainment at Gym,debit,INR,53882.499999999985
2024-04-10,-289.13,Transport,Delhi Metro,Transport at Delhi Metro,debit,INR,53593.36999999999
2024-04-10,-2121.06,Groceries,Big Bazaar,Groceries at Big Bazaar,debit,INR,51472.30999999999
2024-04-11,-1797.15,Groceries,DMart,Groceries at DMart,debit,INR,49675.15999999999
2024-04-11,-605.28,Entertainment,Hotstar,Entertainment at Hotstar,debit,INR,49069.87999999999
2024-04-12,-226.01,Transport,Ola,Transport at Ola,debit,INR,48843.86999999999
2024-04-13,-901.4,Healthcare,Local Clinic,Healthcare at Local Clinic,debit,INR,47942.46999999999
2024-04-14,-465.64,Transport,Auto Rickshaw,Transport at Auto Rickshaw,debit,INR,47476.82999999999
2024-04-14,-83.62,Transport,Indian Oil,Transport at Indian Oil,debit,INR,47393.209999999985
2024-04-14,-1122.72,Groceries,More Supermarket,Groceries at More Supermarket,debit,INR,46270.48999999998
2024-04-15,-880.93,Entertainment,Amazon Prime,Entertainment at Amazon Prime,debit,INR,45389.55999999998
2024-04-15,-1065.87,Groceries,Reliance Fresh,Groceries at Reliance Fresh,debit,INR,44323.68999999998
2024-04-16,-604.69,Other,Miscellaneous,Other at Miscellaneous,debit,INR,43718.99999999998
2024-04-17,-2107.57,Groceries,Spencer's,Groceries at Spencer's,debit,INR,41611.42999999998
2024-04-18,-425.28,Transport,Indian Oil,Transport at Indian Oil,debit,INR,41186.14999999998
2024-04-19,-444.94,Utilities,BESCOM,Utilities at BESCOM,debit,INR,40741.20999999998
2024-04-19,-602.64,Transport,HP Petrol,Transport at HP Petrol,debit,INR,40138.56999999998
2024-04-20,-265.3,Transport,Delhi Metro,Transport at Delhi Metro,debit,INR,39873.269999999975
2024-04-21,-432.44,Transport,Ola,Transport at Ola,debit,INR,39440.82999999997
2024-04-22,-183.66,Dining Out,CCD,Dining Out at CCD,debit,INR,39257.16999999997
2024-04-24,-403.32,Groceries,Big Bazaar,Groceries at Big Bazaar,debit,INR,38853.84999999997
2024-04-25,-2211.6,Groceries,Big Bazaar,Groceries at Big Bazaar,debit,INR,36642.24999999997
2024-04-25,-629.84,Shopping,Local Mall,Shopping at Local Mall,debit,INR,36012.409999999974
2024-04-26,-2398.01,Groceries,DMart,Groceries at DMart,debit,INR,33614.39999999997
2024-04-27,-2664.88,Groceries,Local Kirana,Groceries at Local Kirana,debit,INR,30949.51999999997
2024-04-28,-422.47,Entertainment,Amazon Prime,Entertainment at Amazon Prime,debit,INR,30527.04999999997
2024-04-28,-2757.88,Shopping,Medical Store,Shopping at Medical Store,debit,INR,27769.16999999997
2024-04-29,-1921.37,Groceries,More Supermarket,Groceries at More Supermarket,debit,INR,25847.79999999997
2024-04-29,-532.59,Dining Out,Zomato,Dining Out at Zomato,debit,INR,25315.20999999997
2024-04-29,-1621.59,Groceries,Local Kirana,Groceries at Local Kirana,debit,INR,23693.61999999997
2024-04-30,-2736.92,Shopping,Medical Store,Shopping at Medical Store,debit,INR,20956.699999999968
2024-04-30,-1498.22,Utilities,BWSSB,Utilities at BWSSB,debit,INR,19458.479999999967
2024-05-01,-1477.76,Groceries,Reliance Fresh,Groceries at Reliance Fresh,debit,INR,17980.71999999997
2024-05-02,-5241.24,Shopping,Local Mall,Shopping at Local Mall,debit,INR,12739.479999999969
2024-05-03,-2912.09,Groceries,Local Kirana,Groceries at Local Kirana,debit,INR,9827.389999999968
2024-05-03,-376.93,Transport,BMTC,Transport at BMTC,debit,INR,9450.459999999968
2024-05-03,-439.46,Dining Out,McDonald's India,Dining Out at McDonald's India,debit,INR,9010.999999999969
2024-05-04,-684.15,Other,ATM,Other at ATM,debit,INR,8326.84999999997
2024-05-06,-1454.45,Groceries,Spencer's,Groceries at Spencer's,debit,INR,6872.39999999997
2024-05-06,-571.69,Healthcare,Local Clinic,Healthcare at Local Clinic,debit,INR,6300.70999999997
2024-05-06,-2097.58,Shopping,Flipkart,Shopping at Flipkart,debit,INR,4203.12999999997
2024-05-06,-444.91,Transport,Auto Rickshaw,Transport at Auto Rickshaw,debit,INR,3758.2199999999702
2024-05-07,-2312.85,Groceries,Reliance Fresh,Groceries at Reliance Fresh,debit,INR,1445.3699999999703
2024-05-07,-535.63,Dining Out,CCD,Dining Out at CCD,debit,INR,909.7399999999703
2024-05-07,-1353.38,Groceries,Big Bazaar,Groceries at Big Bazaar,debit,INR,-443.6400000000298
2024-05-08,-320.93,Entertainment,Hotstar,Entertainment at Hotstar,debit,INR,-764.5700000000297
2024-05-08,-348.24,Entertainment,Hotstar,Entertainment at Hotstar,debit,INR,-1112.8100000000297
2024-05-09,-833.81,Groceries,Spencer's,Groceries at Spencer's,debit,INR,-1946.6200000000297
2024-05-09,-252.57,Entertainment,Amazon Prime,Entertainment at Amazon Prime,debit,INR,-2199.1900000000296
2024-05-09,-650.91,Transport,BMTC,Transport at BMTC,debit,INR,-2850.1000000000295
2024-05-10,-283.31,Healthcare,Local Clinic,Healthcare at Local Clinic,debit,INR,-3133.4100000000294
2024-05-10,-2675.84,Groceries,Local Kirana,Groceries at Local Kirana,debit,INR,-5809.250000000029
2024-05-11,-319.19,Entertainment,Hotstar,Entertainment at Hotstar,debit,INR,-6128.440000000029
2024-05-11,-1085.83,Healthcare,Medical Tests,Healthcare at Medical Tests,debit,INR,-7214.270000000029
2024-05-11,-5456.12,Shopping,Myntra,Shopping at Myntra,debit,INR,-12670.390000000029
2024-05-12,-1128.37,Groceries,Reliance Fresh,Groceries at Reliance Fresh,debit,INR,-13798.760000000028
2024-05-14,-714.95,Utilities,BWSSB,Utilities at BWSSB,debit,INR,-14513.710000000028
2024-05-15,-2735.21,Groceries,Spencer's,Groceries at Spencer's,debit,INR,-17248.920000000027
2024-05-17,-4907.6,Shopping,Local Mall,Shopping at Local Mall,debit,INR,-22156.520000000026
2024-05-18,-476.85,Dining Out,CCD,Dining Out at CCD,debit,INR,-22633.370000000024
2024-05-18,-732.57,Healthcare,Apollo Pharmacy,Healthcare at Apollo Pharmacy,debit,INR,-23365.940000000024
2024-05-18,-812.31,Entertainment,Hotstar,Entertainment at Hotstar,debit,INR,-24178.250000000025
2024-05-18,-563.39,Healthcare,Hospital,Healthcare at Hospital,debit,INR,-24741.640000000025
2024-05-19,-272.38,Dining Out,Swiggy,Dining Out at Swiggy,debit,INR,-25014.020000000026
2024-05-19,-863.41,Other,UPI Transfer,Other at UPI Transfer,debit,INR,-25877.430000000026
2024-05-19,-999.25,Other,Online Payment,Other at Online Payment,debit,INR,-26876.680000000026
2024-05-21,-4755.05,Shopping,Flipkart,Shopping at Flipkart,debit,INR,-31631.730000000025
2024-05-21,-116.49,Dining Out,Zomato,Dining Out at Zomato,debit,INR,-31748.220000000027
2024-05-22,-1312.62,Other,Miscellaneous,Other at Miscellaneous,debit,INR,-33060.840000000026
2024-05-23,-515.81,Transport,Uber,Transport at Uber,debit,INR,-33576.65000000002
2024-05-24,-453.93,Transport,BMTC,Transport at BMTC,debit,INR,-34030.58000000002
2024-05-24,-763.85,Groceries,Reliance Fresh,Groceries at Reliance Fresh,debit,INR,-34794.43000000002
2024-05-25,-5254.54,Shopping,Amazon India,Shopping at Amazon India,debit,INR,-40048.97000000002
2024-05-26,-2007.4,Utilities,BWSSB,Utilities at BWSSB,debit,INR,-42056.370000000024
2024-05-26,-532.81,Dining Out,CCD,Dining Out at CCD,debit,INR,-42589.18000000002
2024-05-26,-1385.42,Shopping,Myntra,Shopping at Myntra,debit,INR,-43974.60000000002
2024-05-27,-612.4,Transport,HP Petrol,Transport at HP Petrol,debit,INR,-44587.00000000002
2024-05-28,-507.09,Shopping,Local Mall,Shopping at Local Mall,debit,INR,-45094.09000000002
2024-05-28,-840.46,Other,Online Payment,Other at Online Payment,debit,INR,-45934.55000000002
2024-05-28,-1400.13,Utilities,BESCOM,Utilities at BESCOM,debit,INR,-47334.680000000015
2024-05-29,-764.06,Groceries,Big Bazaar,Groceries at Big Bazaar,debit,INR,-48098.74000000001
2024-05-30,-370.97,Dining Out,KFC,Dining Out at KFC,debit,INR,-48469.710000000014
2024-05-30,-1503.35,Groceries,Reliance Fresh,Groceries at Reliance Fresh,debit,INR,-49973.06000000001
2024-05-30,-1759.15,Groceries,DMart,Groceries at DMart,debit,INR,-51732.210000000014
2024-05-30,-425.5,Dining Out,McDonald's India,Dining Out at McDonald's India,debit,INR,-52157.710000000014
2024-05-31,-1169.49,Shopping,Medical Store,Shopping at Medical Store,debit,INR,-53327.20000000001
2024-05-31,-1240.46,Utilities,Airtel,Utilities at Airtel,debit,INR,-54567.66000000001
2024-05-31,36669.3,Income,Tech Company,Monthly Salary,credit,INR,-17898.360000000008
2024-05-31,-3070.55,Shopping,Brand Factory,Shopping at Brand Factory,debit,INR,-20968.910000000007
2024-06-01,47201.97,Income,Local Business,Monthly Salary,credit,INR,26233.059999999994
2024-06-01,-259.22,Other,UPI Transfer,Other at UPI Transfer,debit,INR,25973.839999999993
2024-06-01,-1829.09,Shopping,Flipkart,Shopping at Flipkart,debit,INR,24144.749999999993
2024-06-01,-3741.38,Shopping,Amazon India,Shopping at Amazon India,debit,INR,20403.36999999999
2024-06-02,-223.36,Groceries,Local Kirana,Groceries at Local Kirana,debit,INR,20180.00999999999
2024-06-03,-1964.75,Shopping,Amazon India,Shopping at Amazon India,debit,INR,18215.25999999999
2024-06-04,-695.1,Dining Out,KFC,Dining Out at KFC,debit,INR,17520.159999999993
2024-06-04,-4688.0,Shopping,Medical Store,Shopping at Medical Store,debit,INR,12832.159999999993
2024-06-05,-549.27,Groceries,Big Bazaar,Groceries at Big Bazaar,debit,INR,12282.889999999992
2024-06-06,-333.52,Transport,HP Petrol,Transport at HP Petrol,debit,INR,11949.369999999992
2024-06-07,-1251.23,Other,Online Payment,Other at Online Payment,debit,INR,10698.139999999992
2024-06-07,-3686.23,Shopping,Local Mall,Shopping at Local Mall,debit,INR,7011.909999999993
2024-06-07,-782.15,Entertainment,PVR Cinemas,Entertainment at PVR Cinemas,debit,INR,6229.759999999993
2024-06-08,-202.06,Entertainment,PVR Cinemas,Entertainment at PVR Cinemas,debit,INR,6027.6999999999925
2024-06-08,-988.72,Entertainment,Amazon Prime,Entertainment at Amazon Prime,debit,INR,5038.979999999992
2024-06-09,-1410.46,Utilities,Airtel,Utilities at Airtel,debit,INR,3628.5199999999923
2024-06-09,-1396.95,Other,ATM,Other at ATM,debit,INR,2231.5699999999924
2024-06-10,-327.79,Transport,HP Petrol,Transport at HP Petrol,debit,INR,1903.7799999999925
2024-06-10,-196.57,Groceries,Big Bazaar,Groceries at Big Bazaar,debit,INR,1707.2099999999925
2024-06-11,-1024.19,Utilities,BWSSB,Utilities at BWSSB,debit,INR,683.0199999999925
2024-06-11,-1645.07,Other,Miscellaneous,Other at Miscellaneous,debit,INR,-962.0500000000075
2024-06-12,-938.56,Groceries,More Supermarket,Groceries at More Supermarket,debit,INR,-1900.6100000000074
2024-06-12,-853.47,Groceries,DMart,Groceries at DMart,debit,INR,-2754.080000000007
2024-06-12,-1801.39,Groceries,Local Kirana,Groceries at Local Kirana,debit,INR,-4555.4700000000075
2024-06-12,-664.55,Transport,HP Petrol,Transport at HP Petrol,debit,INR,-5220.020000000008
2024-06-13,-271.57,Healthcare,Local Clinic,Healthcare at Local Clinic,debit,INR,-5491.590000000007
2024-06-15,-492.97,Entertainment,Amazon Prime,Entertainment at Amazon Prime,debit,INR,-5984.560000000008
2024-06-15,-234.63,Transport,Auto Rickshaw,Transport at Auto Rickshaw,debit,INR,-6219.190000000008
2024-06-15,-1936.06,Groceries,Local Kirana,Groceries at Local Kirana,debit,INR,-8155.250000000007
2024-06-16,-2133.91,Shopping,Brand Factory,Shopping at Brand Factory,debit,INR,-10289.160000000007
2024-06-17,-92.53,Dining Out,KFC,Dining Out at KFC,debit,INR,-10381.690000000008
2024-06-17,-710.22,Utilities,DTH Recharge,Utilities at DTH Recharge,debit,INR,-11091.910000000007
2024-06-18,-313.94,Groceries,Spencer's,Groceries at Spencer's,debit,INR,-11405.850000000008
2024-06-19,-1574.33,Groceries,Reliance Fresh,Groceries at Reliance Fresh,debit,INR,-12980.180000000008
2024-06-19,-853.0,Other,ATM,Other at ATM,debit,INR,-13833.180000000008
2024-06-20,-453.45,Other,Miscellaneous,Other at Miscellaneous,debit,INR,-14286.630000000008
2024-06-20,-523.45,Healthcare,Medical Tests,Healthcare at Medical Tests,debit,INR,-14810.080000000009
2024-06-21,-378.12,Groceries,Big Bazaar,Groceries at Big Bazaar,debit,INR,-15188.20000000001
2024-06-21,-106.6,Dining Out,Zomato,Dining Out at Zomato,debit,INR,-15294.80000000001
2024-06-22,-1259.45,Groceries,Big Bazaar,Groceries at Big Bazaar,debit,INR,-16554.25000000001
2024-06-22,-3958.44,Shopping,Myntra,Shopping at Myntra,debit,INR,-20512.69000000001
2024-06-22,-843.48,Dining Out,CCD,Dining Out at CCD,debit,INR,-21356.17000000001
2024-06-22,-5116.26,Shopping,Local Mall,Shopping at Local Mall,debit,INR,-26472.430000000008
2024-06-23,-1908.37,Groceries,Reliance Fresh,Groceries at Reliance Fresh,debit,INR,-28380.800000000007
2024-06-23,-4579.48,Shopping,Medical Store,Shopping at Medical Store,debit,INR,-32960.280000000006
2024-06-23,-5125.25,Shopping,Local Mall,Shopping at Local Mall,debit,INR,-38085.530000000006
2024-06-23,-785.61,Shopping,Myntra,Shopping at Myntra,debit,INR,-38871.14000000001
2024-06-24,-189.41,Dining Out,Domino's,Dining Out at Domino's,debit,INR,-39060.55000000001
2024-06-25,-183.72,Transport,Indian Oil,Transport at Indian Oil,debit,INR,-39244.27000000001
2024-06-25,-1733.32,Groceries,Reliance Fresh,Groceries at Reliance Fresh,debit,INR,-40977.59000000001
2024-06-25,-290.48,Dining Out,McDonald's India,Dining Out at McDonald's India,debit,INR,-41268.070000000014
2024-06-26,-2991.59,Shopping,Amazon India,Shopping at Amazon India,debit,INR,-44259.66000000002
2024-06-26,-2045.82,Utilities,Reliance Jio,Utilities at Reliance Jio,debit,INR,-46305.48000000002
2024-06-28,-326.96,Dining Out,Zomato,Dining Out at Zomato,debit,INR,-46632.44000000002
2024-06-28,-1947.05,Groceries,DMart,Groceries at DMart,debit,INR,-48579.49000000002
2024-06-30,-2101.24,Shopping,Amazon India,Shopping at Amazon India,debit,INR,-50680.73000000002
2024-07-01,96610.78,Income,Tech Company,Monthly Salary,credit,INR,45930.04999999998
2024-07-01,-342.91,Transport,HP Petrol,Transport at HP Petrol,debit,INR,45587.13999999998
2024-07-02,-149.05,Entertainment,Gym,Entertainment at Gym,debit,INR,45438.089999999975
2024-07-03,-843.59,Healthcare,Medical Tests,Healthcare at Medical Tests,debit,INR,44594.49999999998
2024-07-03,-481.18,Transport,Indian Oil,Transport at Indian Oil,debit,INR,44113.31999999998
2024-07-04,-2301.35,Other,Miscellaneous,Other at Miscellaneous,debit,INR,41811.96999999998
2024-07-05,-1207.93,Utilities,BWSSB,Utilities at BWSSB,debit,INR,40604.03999999998
2024-07-05,-478.51,Utilities,BWSSB,Utilities at BWSSB,debit,INR,40125.52999999998
2024-07-06,-2365.24,Groceries,DMart,Groceries at DMart,debit,INR,37760.28999999998
2024-07-06,-662.4,Transport,Auto Rickshaw,Transport at Auto Rickshaw,debit,INR,37097.88999999998
2024-07-07,-696.26,Transport,Uber,Transport at Uber,debit,INR,36401.629999999976
2024-07-08,-624.95,Dining Out,KFC,Dining Out at KFC,debit,INR,35776.67999999998
2024-07-09,-379.38,Entertainment,Amazon Prime,Entertainment at Amazon Prime,debit,INR,35397.29999999998
2024-07-09,-2248.32,Groceries,Local Kirana,Groceries at Local Kirana,debit,INR,33148.97999999998
2024-07-09,-830.86,Other,Online Payment,Other at Online Payment,debit,INR,32318.11999999998
2024-07-10,-257.85,Entertainment,Netflix India,Entertainment at Netflix India,debit,INR,32060.269999999982
2024-07-10,-1134.55,Groceries,Reliance Fresh,Groceries at Reliance Fresh,debit,INR,30925.719999999983
2024-07-10,-3410.53,Shopping,Amazon India,Shopping at Amazon India,debit,INR,27515.189999999984
2024-07-10,-324.24,Entertainment,PVR Cinemas,Entertainment at PVR Cinemas,debit,INR,27190.949999999983
2024-07-11,-655.6,Healthcare,Doctor Visit,Healthcare at Doctor Visit,debit,INR,26535.349999999984
2024-07-13,-1875.23,Groceries,More Supermarket,Groceries at More Supermarket,debit,INR,24660.119999999984
2024-07-14,-97.49,Transport,BMTC,Transport at BMTC,debit,INR,24562.629999999983
2024-07-15,-2009.38,Groceries,More Supermarket,Groceries at More Supermarket,debit,INR,22553.24999999998
2024-07-16,-372.33,Groceries,Big Bazaar,Groceries at Big Bazaar,debit,INR,22180.91999999998
2024-07-16,-930.5,Groceries,Big Bazaar,Groceries at Big Bazaar,debit,INR,21250.41999999998
2024-07-18,-3464.85,Shopping,Flipkart,Shopping at Flipkart,debit,INR,17785.56999999998
2024-07-18,-587.55,Transport,Indian Oil,Transport at Indian Oil,debit,INR,17198.019999999982
2024-07-18,-667.28,Healthcare,Local Clinic,Healthcare at Local Clinic,debit,INR,16530.739999999983
2024-07-19,-475.83,Transport,BMTC,Transport at BMTC,debit,INR,16054.909999999983
2024-07-22,-467.53,Transport,Ola,Transport at Ola,debit,INR,15587.379999999983
2024-07-22,-889.23,Groceries,Reliance Fresh,Groceries at Reliance Fresh,debit,INR,14698.149999999983
2024-07-22,-1203.92,Groceries,More Supermarket,Groceries at More Supermarket,debit,INR,13494.229999999983
2024-07-23,-760.83,Dining Out,Domino's,Dining Out at Domino's,debit,INR,12733.399999999983
2024-07-24,-972.13,Other,ATM,Other at ATM,debit,INR,11761.269999999984
2024-07-25,-525.79,Groceries,Spencer's,Groceries at Spencer's,debit,INR,11235.479999999985
2024-07-25,-4133.38,Shopping,Myntra,Shopping at Myntra,debit,INR,7102.099999999985
2024-07-25,-1860.94,Utilities,DTH Recharge,Utilities at DTH Recharge,debit,INR,5241.159999999985
2024-07-27,-821.17,Entertainment,Gym,Entertainment at Gym,debit,INR,4419.989999999985
2024-07-27,-904.69,Healthcare,Hospital,Healthcare at Hospital,debit,INR,3515.299999999985
2024-07-27,-1244.55,Utilities,DTH Recharge,Utilities at DTH Recharge,debit,INR,2270.7499999999854
2024-07-28,-433.82,Utilities,Gas Agency,Utilities at Gas Agency,debit,INR,1836.9299999999855
2024-07-28,-2730.7,Shopping,Amazon India,Shopping at Amazon India,debit,INR,-893.7700000000143
2024-07-28,-2222.06,Groceries,Big Bazaar,Groceries at Big Bazaar,debit,INR,-3115.8300000000145
2024-07-28,-1221.27,Groceries,Reliance Fresh,Groceries at Reliance Fresh,debit,INR,-4337.100000000015
2024-07-29,-208.31,Transport,HP Petrol,Transport at HP Petrol,debit,INR,-4545.410000000015
2024-07-29,-1455.88,Utilities,BWSSB,Utilities at BWSSB,debit,INR,-6001.290000000015
2024-07-29,-223.59,Dining Out,KFC,Dining Out at KFC,debit,INR,-6224.880000000016
2024-07-30,-1610.77,Shopping,Medical Store,Shopping at Medical Store,debit,INR,-7835.650000000016
2024-07-30,-1661.97,Groceries,Big Bazaar,Groceries at Big Bazaar,debit,INR,-9497.620000000015
2024-07-30,-41.12,Transport,Auto Rickshaw,Transport at Auto Rickshaw,debit,INR,-9538.740000000016
2024-07-31,-811.88,Groceries,More Supermarket,Groceries at More Supermarket,debit,INR,-10350.620000000015
2024-07-31,-2656.55,Groceries,More Supermarket,Groceries at More Supermarket,debit,INR,-13007.170000000016
2024-08-01,-359.13,Groceries,Big Bazaar,Groceries at Big Bazaar,debit,INR,-13366.300000000016
2024-08-01,84443.07,Income,Local Business,Monthly Salary,credit,INR,71076.76999999999
2024-08-01,-741.11,Groceries,Local Kirana,Groceries at Local Kirana,debit,INR,70335.65999999999
2024-08-02,-1748.44,Utilities,Gas Agency,Utilities at Gas Agency,debit,INR,68587.21999999999
2024-08-03,-471.11,Transport,Uber,Transport at Uber,debit,INR,68116.10999999999
2024-08-04,-870.13,Groceries,Local Kirana,Groceries at Local Kirana,debit,INR,67245.97999999998
2024-08-04,-126.9,Dining Out,McDonald's India,Dining Out at McDonald's India,debit,INR,67119.07999999999
2024-08-04,-768.14,Entertainment,BookMyShow,Entertainment at BookMyShow,debit,INR,66350.93999999999
2024-08-06,-631.21,Dining Out,Domino's,Dining Out at Domino's,debit,INR,65719.72999999998
2024-08-09,-533.68,Dining Out,Zomato,Dining Out at Zomato,debit,INR,65186.04999999998
2024-08-10,-2231.93,Groceries,Local Kirana,Groceries at Local Kirana,debit,INR,62954.11999999998
2024-08-11,-2002.33,Groceries,Big Bazaar,Groceries at Big Bazaar,debit,INR,60951.78999999998
2024-08-12,-1321.25,Utilities,BESCOM,Utilities at BESCOM,debit,INR,59630.53999999998
2024-08-13,-1074.37,Utilities,Gas Agency,Utilities at Gas Agency,debit,INR,58556.16999999998
2024-08-14,-532.37,Dining Out,Zomato,Dining Out at Zomato,debit,INR,58023.799999999974
2024-08-15,-1719.77,Groceries,Local Kirana,Groceries at Local Kirana,debit,INR,56304.02999999998
2024-08-15,-682.58,Transport,HP Petrol,Transport at HP Petrol,debit,INR,55621.449999999975
2024-08-15,-507.69,Transport,Ola,Transport at Ola,debit,INR,55113.75999999997
2024-08-16,-81.66,Transport,HP Petrol,Transport at HP Petrol,debit,INR,55032.09999999997
2024-08-16,-1114.89,Groceries,Spencer's,Groceries at Spencer's,debit,INR,53917.20999999997
2024-08-17,-814.07,Entertainment,Hotstar,Entertainment at Hotstar,debit,INR,53103.13999999997
2024-08-18,-2397.45,Groceries,Spencer's,Groceries at Spencer's,debit,INR,50705.68999999997
2024-08-19,-1564.34,Groceries,More Supermarket,Groceries at More Supermarket,debit,INR,49141.34999999998
2024-08-19,-1453.07,Shopping,Local Mall,Shopping at Local Mall,debit,INR,47688.27999999998
2024-08-20,-476.52,Dining Out,Domino's,Dining Out at Domino's,debit,INR,47211.75999999998
2024-08-21,-765.46,Entertainment,Amazon Prime,Entertainment at Amazon Prime,debit,INR,46446.29999999998
2024-08-21,-847.63,Groceries,Local Kirana,Groceries at Local Kirana,debit,INR,45598.669999999984
2024-08-22,-2348.33,Groceries,DMart,Groceries at DMart,debit,INR,43250.33999999998
2024-08-23,-3195.41,Shopping,Brand Factory,Shopping at Brand Factory,debit,INR,40054.92999999998
2024-08-24,-462.41,Transport,Uber,Transport at Uber,debit,INR,39592.519999999975
2024-08-24,-2688.45,Groceries,More Supermarket,Groceries at More Supermarket,debit,INR,36904.06999999998
2024-08-24,-1283.52,Groceries,Spencer's,Groceries at Spencer's,debit,INR,35620.54999999998
2024-08-25,-2084.28,Groceries,Local Kirana,Groceries at Local Kirana,debit,INR,33536.26999999998
2024-08-26,-2645.41,Groceries,Big Bazaar,Groceries at Big Bazaar,debit,INR,30890.859999999982
2024-08-26,-553.36,Transport,BMTC,Transport at BMTC,debit,INR,30337.49999999998
2024-08-27,-739.3,Entertainment,PVR Cinemas,Entertainment at PVR Cinemas,debit,INR,29598.199999999983
2024-08-27,-99.69,Transport,HP Petrol,Transport at HP Petrol,debit,INR,29498.509999999984
2024-08-27,-2853.79,Shopping,Brand Factory,Shopping at Brand Factory,debit,INR,26644.719999999983
2024-08-27,-798.15,Shopping,Amazon India,Shopping at Amazon India,debit,INR,25846.56999999998
2024-08-28,-252.1,Groceries,Big Bazaar,Groceries at Big Bazaar,debit,INR,25594.469999999983
2024-08-28,-1329.41,Groceries,Local Kirana,Groceries at Local Kirana,debit,INR,24265.059999999983
2024-08-29,-584.91,Dining Out,KFC,Dining Out at KFC,debit,INR,23680.149999999983
2024-08-30,-1136.44,Groceries,Big Bazaar,Groceries at Big Bazaar,debit,INR,22543.709999999985
2024-08-30,-1706.71,Groceries,Reliance Fresh,Groceries at Reliance Fresh,debit,INR,20836.999999999985
2024-08-31,-1174.86,Groceries,Big Bazaar,Groceries at Big Bazaar,debit,INR,19662.139999999985
2024-09-01,43479.74,Income,Tech Company,Monthly Salary,credit,INR,63141.87999999998
2024-09-01,-1133.32,Groceries,Local Kirana,Groceries at Local Kirana,debit,INR,62008.55999999998
2024-09-02,-2012.76,Groceries,Local Kirana,Groceries at Local Kirana,debit,INR,59995.79999999998
2024-09-02,-1323.11,Groceries,Reliance Fresh,Groceries at Reliance Fresh,debit,INR,58672.68999999998
2024-09-02,-527.44,Entertainment,Netflix India,Entertainment at Netflix India,debit,INR,58145.24999999998
2024-09-02,-451.64,Groceries,Reliance Fresh,Groceries at Reliance Fresh,debit,INR,57693.60999999998
2024-09-03,-930.37,Other,Online Payment,Other at Online Payment,debit,INR,56763.239999999976
2024-09-04,-1197.22,Groceries,Reliance Fresh,Groceries at Reliance Fresh,debit,INR,55566.019999999975
2024-09-04,-643.71,Entertainment,Hotstar,Entertainment at Hotstar,debit,INR,54922.309999999976
2024-09-05,-1940.5,Groceries,Local Kirana,Groceries at Local Kirana,debit,INR,52981.809999999976
2024-09-05,-831.86,Healthcare,Medical Tests,Healthcare at Medical Tests,debit,INR,52149.949999999975
2024-09-05,-611.8,Transport,Auto Rickshaw,Transport at Auto Rickshaw,debit,INR,51538.14999999997
2024-09-05,-631.0,Dining Out,Swiggy,Dining Out at Swiggy,debit,INR,50907.14999999997
2024-09-06,-1706.61,Shopping,Myntra,Shopping at Myntra,debit,INR,49200.53999999997
2024-09-06,-2036.93,Groceries,Reliance Fresh,Groceries at Reliance Fresh,debit,INR,47163.60999999997
2024-09-07,-3977.17,Shopping,Myntra,Shopping at Myntra,debit,INR,43186.43999999997
2024-09-08,-1196.19,Healthcare,Apollo Pharmacy,Healthcare at Apollo Pharmacy,debit,INR,41990.24999999997
2024-09-09,-916.73,Shopping,Local Mall,Shopping at Local Mall,debit,INR,41073.51999999997
2024-09-11,-1844.89,Groceries,More Supermarket,Groceries at More Supermarket,debit,INR,39228.62999999997
2024-09-12,-652.89,Transport,Delhi Metro,Transport at Delhi Metro,debit,INR,38575.73999999997
2024-09-12,-1182.44,Groceries,Big Bazaar,Groceries at Big Bazaar,debit,INR,37393.29999999997
2024-09-12,-1004.97,Groceries,DMart,Groceries at DMart,debit,INR,36388.329999999965
2024-09-13,-829.73,Healthcare,Doctor Visit,Healthcare at Doctor Visit,debit,INR,35558.59999999996
2024-09-14,-1917.64,Groceries,DMart,Groceries at DMart,debit,INR,33640.95999999996
2024-09-14,-377.39,Transport,Auto Rickshaw,Transport at Auto Rickshaw,debit,INR,33263.56999999996
2024-09-14,-1010.41,Groceries,Spencer's,Groceries at Spencer's,debit,INR,32253.159999999963
2024-09-15,-274.46,Entertainment,Netflix India,Entertainment at Netflix India,debit,INR,31978.699999999964
2024-09-16,-623.85,Groceries,DMart,Groceries at DMart,debit,INR,31354.849999999966
2024-09-17,-3791.38,Shopping,Local Mall,Shopping at Local Mall,debit,INR,27563.469999999965
2024-09-17,-276.89,Entertainment,Gym,Entertainment at Gym,debit,INR,27286.579999999965
2024-09-18,-216.25,Entertainment,Hotstar,Entertainment at Hotstar,debit,INR,27070.329999999965
2024-09-18,-654.85,Transport,Indian Oil,Transport at Indian Oil,debit,INR,26415.479999999967
2024-09-18,-403.93,Utilities,Reliance Jio,Utilities at Reliance Jio,debit,INR,26011.549999999967
2024-09-18,-2642.52,Shopping,Amazon India,Shopping at Amazon India,debit,INR,23369.029999999966
2024-09-19,-542.1,Dining Out,Swiggy,Dining Out at Swiggy,debit,INR,22826.929999999968
2024-09-19,-972.46,Groceries,DMart,Groceries at DMart,debit,INR,21854.46999999997
2024-09-22,-3973.52,Shopping,Local Mall,Shopping at Local Mall,debit,INR,17880.949999999968
2024-09-23,-1429.61,Utilities,BWSSB,Utilities at BWSSB,debit,INR,16451.339999999967
2024-09-23,-652.23,Entertainment,PVR Cinemas,Entertainment at PVR Cinemas,debit,INR,15799.109999999968
2024-09-24,-293.08,Utilities,Gas Agency,Utilities at Gas Agency,debit,INR,15506.029999999968
2024-09-24,-1168.57,Groceries,Local Kirana,Groceries at Local Kirana,debit,INR,14337.459999999968
2024-09-25,-805.78,Dining Out,McDonald's India,Dining Out at McDonald's India,debit,INR,13531.679999999968
2024-09-27,-731.52,Dining Out,Swiggy,Dining Out at Swiggy,debit,INR,12800.159999999967
2024-09-27,-415.11,Dining Out,Domino's,Dining Out at Domino's,debit,INR,12385.049999999967
2024-09-28,-360.67,Healthcare,Local Clinic,Healthcare at Local Clinic,debit,INR,12024.379999999966
2024-09-28,-1075.6,Groceries,Spencer's,Groceries at Spencer's,debit,INR,10948.779999999966
2024-09-29,-464.19,Dining Out,Zomato,Dining Out at Zomato,debit,INR,10484.589999999966
2024-09-30,-342.14,Transport,HP Petrol,Transport at HP Petrol,debit,INR,10142.449999999966
2024-10-01,-956.25,Utilities,DTH Recharge,Utilities at DTH Recharge,debit,INR,9186.199999999966
2024-10-01,-996.99,Groceries,Local Kirana,Groceries at Local Kirana,debit,INR,8189.209999999966
2024-10-02,-550.13,Dining Out,CCD,Dining Out at CCD,debit,INR,7639.079999999966
2024-10-02,-225.5,Entertainment,BookMyShow,Entertainment at BookMyShow,debit,INR,7413.579999999966
2024-10-03,-475.17,Other,Online Payment,Other at Online Payment,debit,INR,6938.409999999966
2024-10-04,-543.39,Shopping,Flipkart,Shopping at Flipkart,debit,INR,6395.019999999966
2024-10-05,-287.53,Groceries,Local Kirana,Groceries at Local Kirana,debit,INR,6107.489999999966
2024-10-06,-319.77,Dining Out,Local Restaurant,Dining Out at Local Restaurant,debit,INR,5787.719999999967
2024-10-08,-531.19,Transport,Delhi Metro,Transport at Delhi Metro,debit,INR,5256.529999999966
2024-10-08,-2589.93,Shopping,Brand Factory,Shopping at Brand Factory,debit,INR,2666.5999999999663
2024-10-09,-2005.64,Shopping,Myntra,Shopping at Myntra,debit,INR,660.9599999999662
2024-10-09,-1270.17,Groceries,Local Kirana,Groceries at Local Kirana,debit,INR,-609.2100000000339
2024-10-10,-1165.85,Other,Miscellaneous,Other at Miscellaneous,debit,INR,-1775.0600000000338
2024-10-10,-843.54,Groceries,More Supermarket,Groceries at More Supermarket,debit,INR,-2618.600000000034
2024-10-10,-1256.67,Shopping,Local Mall,Shopping at Local Mall,debit,INR,-3875.270000000034
2024-10-10,-394.64,Dining Out,Local Restaurant,Dining Out at Local Restaurant,debit,INR,-4269.910000000034
2024-10-11,-1884.25,Groceries,DMart,Groceries at DMart,debit,INR,-6154.160000000034
2024-10-12,-972.3,Shopping,Brand Factory,Shopping at Brand Factory,debit,INR,-7126.460000000035
2024-10-14,-801.31,Groceries,Local Kirana,Groceries at Local Kirana,debit,INR,-7927.770000000035
2024-10-14,-2627.21,Shopping,Local Mall,Shopping at Local Mall,debit,INR,-10554.980000000036
2024-10-14,-870.59,Healthcare,Doctor Visit,Healthcare at Doctor Visit,debit,INR,-11425.570000000036
2024-10-16,-1121.15,Groceries,Big Bazaar,Groceries at Big Bazaar,debit,INR,-12546.720000000036
2024-10-16,-615.27,Transport,Indian Oil,Transport at Indian Oil,debit,INR,-13161.990000000036
2024-10-16,-345.51,Entertainment,BookMyShow,Entertainment at BookMyShow,debit,INR,-13507.500000000036
2024-10-17,-356.57,Transport,BMTC,Transport at BMTC,debit,INR,-13864.070000000036
2024-10-17,-322.52,Groceries,Reliance Fresh,Groceries at Reliance Fresh,debit,INR,-14186.590000000037
2024-10-18,-100.19,Transport,HP Petrol,Transport at HP Petrol,debit,INR,-14286.780000000037
2024-10-18,-1147.32,Groceries,More Supermarket,Groceries at More Supermarket,debit,INR,-15434.100000000037
2024-10-19,-2813.3,Shopping,Local Mall,Shopping at Local Mall,debit,INR,-18247.400000000038
2024-10-19,-1489.98,Utilities,Airtel,Utilities at Airtel,debit,INR,-19737.380000000037
2024-10-20,-231.91,Transport,Auto Rickshaw,Transport at Auto Rickshaw,debit,INR,-19969.290000000037
2024-10-21,-850.29,Utilities,BWSSB,Utilities at BWSSB,debit,INR,-20819.580000000038
2024-10-22,-3302.49,Shopping,Flipkart,Shopping at Flipkart,debit,INR,-24122.070000000036
2024-10-22,-268.98,Dining Out,Zomato,Dining Out at Zomato,debit,INR,-24391.050000000036
2024-10-22,-408.99,Dining Out,Local Restaurant,Dining Out at Local Restaurant,debit,INR,-24800.040000000037
2024-10-23,-623.78,Transport,Ola,Transport at Ola,debit,INR,-25423.820000000036
2024-10-23,-381.88,Dining Out,Local Restaurant,Dining Out at Local Restaurant,debit,INR,-25805.700000000037
2024-10-24,-1260.73,Shopping,Local Mall,Shopping at Local Mall,debit,INR,-27066.430000000037
2024-10-24,-657.71,Transport,HP Petrol,Transport at HP Petrol,debit,INR,-27724.140000000036
2024-10-25,-682.71,Dining Out,Local Restaurant,Dining Out at Local Restaurant,debit,INR,-28406.850000000035
2024-10-25,-796.99,Groceries,Big Bazaar,Groceries at Big Bazaar,debit,INR,-29203.840000000037
2024-10-25,-623.53,Dining Out,McDonald's India,Dining Out at McDonald's India,debit,INR,-29827.370000000035
2024-10-26,-426.38,Utilities,BWSSB,Utilities at BWSSB,debit,INR,-30253.750000000036
2024-10-26,-878.77,Transport,Ola,Transport at Ola,debit,INR,-31132.520000000037
2024-10-27,-3419.44,Shopping,Local Mall,Shopping at Local Mall,debit,INR,-34551.960000000036
2024-10-28,-1825.73,Groceries,DMart,Groceries at DMart,debit,INR,-36377.69000000004
2024-10-29,-1333.76,Groceries,Big Bazaar,Groceries at Big Bazaar,debit,INR,-37711.45000000004
2024-10-30,-787.1,Groceries,Spencer's,Groceries at Spencer's,debit,INR,-38498.55000000004
2024-10-30,-1091.29,Entertainment,PVR Cinemas,Entertainment at PVR Cinemas,debit,INR,-39589.84000000004
2024-10-31,98154.56,Income,Local Business,Monthly Salary,credit,INR,58564.71999999996
2024-11-01,44276.06,Income,Tech Company,Monthly Salary,credit,INR,102840.77999999996
2024-11-01,-1897.49,Groceries,More Supermarket,Groceries at More Supermarket,debit,INR,100943.28999999995
2024-11-02,-700.8,Dining Out,KFC,Dining Out at KFC,debit,INR,100242.48999999995
2024-11-02,-2448.57,Groceries,Big Bazaar,Groceries at Big Bazaar,debit,INR,97793.91999999994
2024-11-02,-573.08,Dining Out,CCD,Dining Out at CCD,debit,INR,97220.83999999994
2024-11-04,-324.27,Dining Out,KFC,Dining Out at KFC,debit,INR,96896.56999999993
2024-11-04,-609.55,Utilities,BWSSB,Utilities at BWSSB,debit,INR,96287.01999999993
2024-11-04,-405.05,Groceries,Spencer's,Groceries at Spencer's,debit,INR,95881.96999999993
2024-11-05,-685.81,Transport,Ola,Transport at Ola,debit,INR,95196.15999999993
2024-11-05,-619.69,Groceries,More Supermarket,Groceries at More Supermarket,debit,INR,94576.46999999993
2024-11-05,-1018.81,Shopping,Medical Store,Shopping at Medical Store,debit,INR,93557.65999999993
2024-11-06,-946.48,Other,UPI Transfer,Other at UPI Transfer,debit,INR,92611.17999999993
2024-11-06,-1482.86,Utilities,BESCOM,Utilities at BESCOM,debit,INR,91128.31999999993
2024-11-07,-2753.63,Groceries,Big Bazaar,Groceries at Big Bazaar,debit,INR,88374.68999999993
2024-11-08,-1316.85,Other,ATM,Other at ATM,debit,INR,87057.83999999992
2024-11-09,-2016.85,Groceries,DMart,Groceries at DMart,debit,INR,85040.98999999992
2024-11-10,-360.97,Transport,Uber,Transport at Uber,debit,INR,84680.01999999992
2024-11-11,-3256.78,Shopping,Amazon India,Shopping at Amazon India,debit,INR,81423.23999999992
2024-11-11,-1309.06,Utilities,Reliance Jio,Utilities at Reliance Jio,debit,INR,80114.17999999992
2024-11-11,-1477.56,Groceries,Spencer's,Groceries at Spencer's,debit,INR,78636.61999999992
2024-11-11,-519.08,Transport,Ola,Transport at Ola,debit,INR,78117.53999999992
2024-11-12,-5779.98,Shopping,Brand Factory,Shopping at Brand Factory,debit,INR,72337.55999999992
2024-11-13,-962.51,Other,ATM,Other at ATM,debit,INR,71375.04999999993
2024-11-13,-724.29,Shopping,Myntra,Shopping at Myntra,debit,INR,70650.75999999994
2024-11-14,-1667.89,Other,Miscellaneous,Other at Miscellaneous,debit,INR,68982.86999999994
2024-11-15,-713.39,Transport,Auto Rickshaw,Transport at Auto Rickshaw,debit,INR,68269.47999999994
2024-11-16,-385.16,Entertainment,Netflix India,Entertainment at Netflix India,debit,INR,67884.31999999993
2024-11-17,-2701.5,Groceries,Big Bazaar,Groceries at Big Bazaar,debit,INR,65182.819999999934
2024-11-17,-202.53,Groceries,Big Bazaar,Groceries at Big Bazaar,debit,INR,64980.289999999935
2024-11-18,-735.36,Shopping,Amazon India,Shopping at Amazon India,debit,INR,64244.929999999935
2024-11-19,-1377.29,Other,Miscellaneous,Other at Miscellaneous,debit,INR,62867.639999999934
2024-11-19,-2298.9,Groceries,Big Bazaar,Groceries at Big Bazaar,debit,INR,60568.73999999993
2024-11-19,-354.59,Dining Out,McDonald's India,Dining Out at McDonald's India,debit,INR,60214.149999999936
2024-11-20,-268.0,Transport,Delhi Metro,Transport at Delhi Metro,debit,INR,59946.149999999936
2024-11-21,-439.85,Healthcare,Apollo Pharmacy,Healthcare at Apollo Pharmacy,debit,INR,59506.29999999994
2024-11-21,-235.47,Other,Online Payment,Other at Online Payment,debit,INR,59270.829999999936
2024-11-22,-398.59,Transport,Delhi Metro,Transport at Delhi Metro,debit,INR,58872.23999999994
2024-11-22,-4132.93,Shopping,Local Mall,Shopping at Local Mall,debit,INR,54739.30999999994
2024-11-22,-547.2,Transport,Uber,Transport at Uber,debit,INR,54192.10999999994
2024-11-23,-1567.26,Groceries,Reliance Fresh,Groceries at Reliance Fresh,debit,INR,52624.84999999994
2024-11-24,-821.04,Entertainment,BookMyShow,Entertainment at BookMyShow,debit,INR,51803.80999999994
2024-11-25,-1027.51,Other,ATM,Other at ATM,debit,INR,50776.29999999994
2024-11-26,-398.86,Transport,Delhi Metro,Transport at Delhi Metro,debit,INR,50377.43999999994
2024-11-26,-4243.25,Shopping,Medical Store,Shopping at Medical Store,debit,INR,46134.18999999994
2024-11-27,-1521.99,Utilities,BESCOM,Utilities at BESCOM,debit,INR,44612.19999999994
2024-11-28,-1478.93,Utilities,Reliance Jio,Utilities at Reliance Jio,debit,INR,43133.26999999994
2024-11-28,-300.23,Transport,Delhi Metro,Transport at Delhi Metro,debit,INR,42833.039999999935
2024-11-29,-2580.27,Groceries,Spencer's,Groceries at Spencer's,debit,INR,40252.76999999994
2024-11-30,-261.51,Groceries,Reliance Fresh,Groceries at Reliance Fresh,debit,INR,39991.25999999994
2024-12-01,101283.88,Income,Tech Company,Monthly Salary,credit,INR,141275.13999999996
2024-12-01,-514.27,Transport,Auto Rickshaw,Transport at Auto Rickshaw,debit,INR,140760.86999999997
2024-12-01,-1638.01,Utilities,Reliance Jio,Utilities at Reliance Jio,debit,INR,139122.85999999996
2024-12-01,-1090.67,Healthcare,Doctor Visit,Healthcare at Doctor Visit,debit,INR,138032.18999999994
2024-12-02,-1798.33,Groceries,More Supermarket,Groceries at More Supermarket,debit,INR,136233.85999999996
2024-12-03,-668.16,Groceries,Spencer's,Groceries at Spencer's,debit,INR,135565.69999999995
2024-12-04,-608.24,Entertainment,Hotstar,Entertainment at Hotstar,debit,INR,134957.45999999996
2024-12-04,-552.69,Shopping,Myntra,Shopping at Myntra,debit,INR,134404.76999999996
2024-12-05,-549.55,Transport,HP Petrol,Transport at HP Petrol,debit,INR,133855.21999999997
2024-12-05,-1787.23,Shopping,Flipkart,Shopping at Flipkart,debit,INR,132067.98999999996
2024-12-08,-1072.41,Groceries,Big Bazaar,Groceries at Big Bazaar,debit,INR,130995.57999999996
2024-12-09,-3420.08,Shopping,Local Mall,Shopping at Local Mall,debit,INR,127575.49999999996
2024-12-10,-230.35,Transport,Delhi Metro,Transport at Delhi Metro,debit,INR,127345.14999999995
2024-12-10,-1142.6,Other,Miscellaneous,Other at Miscellaneous,debit,INR,126202.54999999994
2024-12-11,-425.73,Transport,Delhi Metro,Transport at Delhi Metro,debit,INR,125776.81999999995
2024-12-11,-1087.6,Entertainment,PVR Cinemas,Entertainment at PVR Cinemas,debit,INR,124689.21999999994
2024-12-12,-1070.24,Entertainment,Hotstar,Entertainment at Hotstar,debit,INR,123618.97999999994
2024-12-12,-1632.21,Shopping,Myntra,Shopping at Myntra,debit,INR,121986.76999999993
2024-12-14,-610.31,Transport,Delhi Metro,Transport at Delhi Metro,debit,INR,121376.45999999993
2024-12-14,-1459.92,Shopping,Amazon India,Shopping at Amazon India,debit,INR,119916.53999999994
2024-12-15,-1890.7,Groceries,More Supermarket,Groceries at More Supermarket,debit,INR,118025.83999999994
2024-12-16,-3055.78,Shopping,Brand Factory,Shopping at Brand Factory,debit,INR,114970.05999999994
2024-12-18,-67.29,Transport,Indian Oil,Transport at Indian Oil,debit,INR,114902.76999999995
2024-12-18,-285.99,Transport,Uber,Transport at Uber,debit,INR,114616.77999999994
2024-12-19,-4349.55,Shopping,Local Mall,Shopping at Local Mall,debit,INR,110267.22999999994
2024-12-20,-2625.57,Groceries,Local Kirana,Groceries at Local Kirana,debit,INR,107641.65999999993
2024-12-20,-1395.28,Utilities,Reliance Jio,Utilities at Reliance Jio,debit,INR,106246.37999999993
2024-12-21,-630.98,Entertainment,Hotstar,Entertainment at Hotstar,debit,INR,105615.39999999994
2024-12-22,-4989.5,Shopping,Local Mall,Shopping at Local Mall,debit,INR,100625.89999999994
2024-12-22,-338.79,Transport,Ola,Transport at Ola,debit,INR,100287.10999999994
2024-12-23,-2145.82,Shopping,Brand Factory,Shopping at Brand Factory,debit,INR,98141.28999999994
2024-12-24,-448.72,Dining Out,KFC,Dining Out at KFC,debit,INR,97692.56999999993
2024-12-24,-217.94,Transport,BMTC,Transport at BMTC,debit,INR,97474.62999999993
2024-12-25,-2166.8,Groceries,Spencer's,Groceries at Spencer's,debit,INR,95307.82999999993
2024-12-25,-1399.51,Groceries,Local Kirana,Groceries at Local Kirana,debit,INR,93908.31999999993
2024-12-26,-510.34,Groceries,More Supermarket,Groceries at More Supermarket,debit,INR,93397.97999999994
2024-12-27,-633.49,Transport,Uber,Transport at Uber,debit,INR,92764.48999999993
2024-12-27,-1265.13,Groceries,Local Kirana,Groceries at Local Kirana,debit,INR,91499.35999999993
2024-12-28,-665.58,Transport,Indian Oil,Transport at Indian Oil,debit,INR,90833.77999999993
2024-12-28,-1016.5,Groceries,Local Kirana,Groceries at Local Kirana,debit,INR,89817.27999999993
2024-12-29,-547.03,Groceries,Spencer's,Groceries at Spencer's,debit,INR,89270.24999999993
2024-12-30,-325.57,Dining Out,McDonald's India,Dining Out at McDonald's India,debit,INR,88944.67999999992
2024-12-31,-536.33,Transport,BMTC,Transport at BMTC,debit,INR,88408.34999999992
